NO ./textures/north.xpm
SO ./textures/south.xpm
WE ./textures/west.xpm
EA ./textures/east.xpm

F 220,100,0
C 225,30,0

1111111111111111
1111010111100011
1010101011101011
1110W11101010011

1110W11101010011
1110001000001011
1001000001000101
1101011100000101
1111111111111111
