NO ./textures/north.xpm
SO ./textures/south.xpm
WE ./textures/west.xpm
EA ./textures/east.xpm

F -10,100,0
C 225,30,0

1111111111
1001000001
1111010101
1010010001
1001010101
1101010011
1000000011
1001101011
1011000001
1100011101
1000010111
1111000101
1000110001
1000110001
1010110001
1001000011
1011111011
10000110E1
1100010011
1011110101
1111111111
