NO ./textures/north.xpm
SO ./textures/south.xpm
WE ./textures/west.xpm
EA ./textures/east.xpm

F 220,100,0
C 225,30,0

111111111111111111
100001001000000001
100101000000100001
10000
110100000011100011
101001000100011111
111111111111111111
