NO ./textures/north.xpm
SO ./textures/south.xpm
WE ./textures/west.xpm
EA ./textures/east.xpm

F 220,100,0
C 225,30,0

1111111111111111
1111000001000011
1111001000011111
1000011110110101
1000101000000001
1100000011000011
1001011101000101
1011000001101011
1010101000001111
101011101E110101
1110010101100111
1011100100001101
1001001011001111
1110011110000101
1001011000011011
1111111100
