NO ./textures/north.xpm
SO ./textures/south.xpm
WE ./textures/west.xpm
EA ./textures/east.xpm

F 220,100,0
C 225,30,0

111111111111111111111111111
100100001000000000001010001
100001000010010010000100001
100001000100101001100000101
110110010101011100010000001
101000000101010010000010001
100000100010000000010110001
110101011110000010010000011
101000000011001110101001001
100000011000001100001S00101
101100000100011100101000001
100000001000011101110000111
100000001000110000000010001
100001000010000010000000101
111111111111111111111111111
