NO ./textures/north.xpm
SO ./textures/south.xpm
WE ./textures/west.xpm
EA ./textures/east.xpm

F 220,100,0

111111111111111
111010100100111
110110000111001
100001000000101
110010010101001
110000100000001
110100010N00001
111111111111111
