NO ./textures/north.xpm
SO ./textures/south.xpm
WE ./textures/west.xpm
EA ./textures/east.xpm

F 220,100,0
C 225,30,0

11111111111111111
10100000011001001
10101000010100001
10000001100000001
10111000011010001
10000010100101001
11011001000100011
10100001001010001
10000010110001011
10101000010111001
11000010110001011
10100101000011001
11010000101011011
11111111111111111
