NO ./textures/north.xpm
SO ./textures/south.xpm
WE ./textures/west.xpm
EA ./textures/east.xpm

F 220 100 0
C 225,30,0

111111111111111111111111
111001000011001100100011
101010000101001000001111
100100000010111111101001
100100010100100110011011
100101010101000000000001
111010110111011100101011
110110000111000010010011
100001001010001110100001
100000001010000010100101
100101001010100110100101
101110000000101011101001
110011011010000010111011
10010011100W001000000001
111111111111111111111111
