NO ./textures/north.xpm
SO ./textures/south.xpm
WE ./textures/west.xpm
EA ./textures/east.xpm

F 220,100,0
C 225,30,0

111111111111111111
101S01000111000101
100001010101101011
110000000001001011
100000010010101001
110101000000000111
100001000000100001
1111111100
