NO ./textures/north.xpm
SO ./textures/south.xpm
WE ./textures/west.xpm
EA ./textures/east.xpm

F 220,100,0
C 225,30,0

11111111111111111111111111
1110S010000101000000000001
101S0000010000000000100001
10S10100000000100001011001
1N0S0000000000100000100001
101S0000000001001000000001
10S00000100000000010101101
10S00100010010001000000001
110S0001000000100100000001
1101S101001010010010000001
10S00000100000110010000001
110S0000000110000100000001
11111111111111111111111111
