NO ./textures/north.xpm
SO ./textures/south.xpm
WE ./textures/west.xpm

F 220,100,0
C 225,30,0

111111111111111111111111111
111011101001111000111101011
100111000E01000000110000111
110100101101010010000110101
100000100000011010100111101
110001000110111000000101001
100100000101001110101010001
111111111111111111111111111
