NO ./textures/north.xpm
SO ./textures/south.xpm
WE ./textures/west.xpm
EA ./textures/east.xpm

F 382,100,0
C 225,30,0

1111111111
1000000001
101010S101
1000000101
1011110111
1000000011
1000000001
1000100001
1000000001
1110001101
1111111111
