NO ./textures/north.xpm
NO ./textures/north.xpm
SO ./textures/south.xpm
WE ./textures/west.xpm
EA ./textures/east.xpm

F 220,100,0
C 225,30,0

11111111111111111
11000000101000101
10000000000011001
11000010000011011
10001000101010101
11001000000010001
10000010000110011
101100001W1110001
10101010000000001
10011011000110101
10000101110111011
11001000000010001
10010000010000101
10001000000000001
10100000101011011
11010001011100111
11001101101101101
11001011111100011
10101111011001011
10010110000001101
11000010000001001
11111111111111111
