NO ./textures/north.xpm
SO ./textures/south.xpm
WE ./textures/west.xpm
EA ./textures/east.xpm

F 220,100,0
C 225,30,0

11111111111111111111111111
111 0101000001000000100001
11 00000110000000000000001
11 00100010001000010000011
1 000100001000000001010001
1 000000001000000000010011
11 00000000000001000001011
1 001000110101010000000011
11 00000001000000010011001
1 001100011000011000011011
1 000100001110000010000001
1 010010110000000000000001
1 000011010000000001000001
11 00110100110100100011101
1 100000100100010010000011
1 000E00000000000000000001
1 100011000001000000000011
1 101010001000001000110001
11111111111111111111111111
