NO ./textures/north.xpm
SO ./textures/south.xpm
WE ./textures/west.xpm
EA ./textures/east.xpm

F 220,100,0
C 225,30,0

11111111111111111111111
11101010110010110110101
10001100101100111011011
11001100001100100000011
11101011110001100111111
10011010111001001011011
10101100000011000001011
11100110101010000001001
11011001110011011011011
11100010110111101010101
10000100000100000010101
10101001101000000001001
11101001000010011111011
1100001100010010010N001
11001000000101010100001
10000010010010100010001
10110010011101001100111
11100011111100100000011
10011011111001110100101
11111111111111111111111
