NO ./textures/north.xpm
SO ./textures/south.xpm
WE ./textures/west.xpm
EA ./textures/east.xpm

F 220,100,0
C 225,30,0

1111111111111111111111111111
1010010001001010100101100001
1111010011110111001110001111
1100100000111111010100000001
1101100000001110001101111011
1001100011011110011011000001
1100010001110011100001001001
1111111001101000101000100111
1011010111010101000010110001
1001111010011011101001110111
111100W101011100001110110001
1000010101011101100101101101
1111110001011000100010110101
1010101100001110010011000111
1111111111111111111111111111
