NO ./textures/north.xpm
SO ./textures/south.xpm
WE ./textures/west.xpm
EA ./textures/east.xpm

F 220,100,0
C 225,30,0

11111111111111111
10011001N10000001
11000101111100101
10001001000110011
11010100010001011
10010111010000001
11001011100010001
10100000000010001
10001001000010111
11001000011000001
10000000010001011
11111111111111111
