NO ./textures/north.xpm
SO ./textures/south.xpm
WE ./textures/west.xpm
EA ./textures/east.xpm

F 220,100,0
C 225,30,0

11111111111111111111
10011010001100100001
11000100101000100101
10100100000100000001
10000000000111000111
10000011001100000011
11110101000101000001
110010E0010001000001
10100000110010000001
11111111111111111111
