NO ./textures/north.xpm
SO ./textures/south.xpm
WE ./textures/west.xpm
EA ./textures/east.xpm

F 220,100,0
C 225,30,0

11111111111
10000000001
11001000001
10000000101
11110011001
10100000001
11111100101
10001001001
10000000101
10100110011
11100000101
10000010001
11100100001
1E011010001
10000000101
10010001001
11111111111
