NO ./textures/north.xpm
SO ./textures/south.xpm
WE ./textures/west.xpm
EA ./textures/east.xpm

F 220,100,0
C 225,30,0

11111111111111
11001101101101
11111100101101
11110011001101
10000100101001
10111000101001
10101111001101
10101010110011
10000010010111
10S00011100111
10001100101001
11111111111111
