NO ./textures/north.xpm
SO ./textures/south.xpm
WE ./textures/west.xpm
EA ./textures/east.xpm

F 220,100,0
C 225,30,0

11111111111111
11000001000011
11000011001001
10000000000001
10100011100011
10100010000001
11100001110011
10000001101011
10001000100001
10001000110111
11101000001001
10111011000011
10110S10000101
10000010101011
11000000000001
10010010000011
11111111111111
