NO ./textures/north.xpm
SO ./textures/south.xpm
WE ./textures/west.xpm
EA ./textures/east.xpm

F 220,100,0
C 225,30,0

11111111111111111
11101000001010001
10000010011111101
10000100100010101
10010000000000001
10000010001010001
10010100100000001
10011100101010001
10000100000001001
10010001010011011
11011001000000001
10011010000000101
10000100000000111
10101100010001111
11000000100000111
10100110000011001
10001000111011001
11000010100000111
10000101010100001
11000111000S10001
10010100011000111
11111111111111111
