NO ./textures/north.xpm
SO ./textures/south.xpm
WE ./textures/west.xpm
EA ./textures/east.xpm

F 220,100,0
C 225,30,0

1111111111111111111
1000101000011100001
1001010010000101001
1111010011000100011
1011000000010010101
1010111110001010001
1000010000100000111
1001101111100010011
1010110001010011111
1101100100001000001
1100000000000101001
11001110000100100N1
1100101001001100011
1111111111111111111
