NO ./textures/north.xpm
SO ./textures/south.xpm
WE ./textures/west.xpm
EA ./textures/east.xpm

F 220,100,0
C 225,30,0

1111111111111
1100010010111
1100011110111
1101101001001
1000001100001
110010S110011
1000001100001
1111111111111
